##############################
##############################
##..........................##
##..........................##
##..........................##
##.....#################....##
##.....#################....##
##.....#################....##
##.....###@@@@@@@@@@@###....##
##.....###@@@@@@@@@@@###....##
##.....###@@@@@@@@@@@###....##
##.....###@@@@@@@@@@@###....##
##.....###@@@@@@@@@@@###....##
##.....###@@@@@@e@@@@###....##
##.....###@@@@$@e@@@@###....##
##.....###@@@@@@@@@@@###....##
##.....###@@@@@@@@@@@###....##
##~~~~~###@@@@@@@@@@@###~~~~##
##~~~~~###@@@@@@@@@@@###~~~~##
##~~~~~###@@@@@@@@@@@###~~~~##
##.....#######@@@#######....##
##.....#######@@@#######....##
##.....#######@@@#######....##
##..........................##
##..........................##
##..........................##
##..........................##
##..........................##
##############################
##############################
