##############################
##############################
##..........................##
##..........................##
##..........................##
##...####################...##
##...####################...##
##...##@@@@@@@@@@@@@@@@##...##
##...##@@@@@@@@@@@@@@@@##...##
##...##@@##@@####@@##@@##...##
##...##@@##@@####@@##@@##...##
##...##@@@@@@@@@@@@@@@@##...##
##...##@@@@@@@@@@@@@@@@##...##
##...########@@@#########...##
##...########@@@#########...##
##...........@@@............##
##...........@@@............##
##~~~~~~~~~~~@@@~~~~~~~~~~~~##
##~~~~~~~~~~~@@@~~~~~~~~~~~~##
##~~~~~~~~~~~@@@~~~~~~~~~~~~##
##...........@$@............##
##...........@@@............##
##...........@@@............##
##...........@@@............##
##...........@@@............##
##...........@@@............##
##...........@@@............##
##...........@@@............##
##############################
##############################
